Plateau 15 17:
    01234567890123456
000 OOOOOOOXXXXXXXXX.
001 OOOOOOOXXXXXXXXX.
002 OOOOOOOXXXXXXXXX.
003 OOOOOOOOOXXXXXXX.
004 OOOOXOOOOOXXXXXX.
005 OOOOXXXXXXXXXXXX.
006 OOOXXXXXXXXXXXXX.
007 .OOXXXXXXXXXXXXX.
008 OOOXXXXXXXXXXXXX.
009 XXXXXXXXXXXXXXXX.
010 XXXXXXXXXXXXXXXX.
011 XXXXXXXXXXXXXXXX.
012 XXXXXXXXXXXXXXXX.
013 xXXXXXXXXXXXXXXX.
014 x.....XX.........
Piece 2 3:
**.
.**